yy..rgyrrygr..yy
..gg........gg..
....r.rrrr.r....
.yyy.g....g.yyy.
.rrg...yy...grr.
....r.rrrr.r....
..gg........gg..
yy..rgyrrygr..yy
................
................
................
................
................
................
