................
yyyyyyyyyyyyyyyy
ggg.r.r..r.r.ggg
y..r.g.yy.g.r..y
.yyyyyggggyyyyy.
.gg..rr..rr..gg.
...yy......yy...
.....rg..gr.....
.......rr.......
................
................
................
................
................
