g..............g
.y............y.
rrrrrrrrrrrrrrrr
.g.yyyyyyyyyy.g.
.g............g.
.g.rrrrrrrrrr.g.
.g............g.
.g.yyyyyyyyyy.g.
................
.g.rrrrrrrrrr.g.
................
................
................
................
