r...yyyyyyyy...r
y..g...gg...g..y
..g....rr....g..
.r..grryyrrg..r.
..g....rr....g..
r..g...gg...g..r
g...yyyyyyyy...g
rryy........yyrr
....r.yggy.r....
................
................
................
................
................
