.gggggggggggggg.
.yr..........ry.
.y..g......g..y.
.g.....rr.....g.
.r..g......g..r.
.ry..........yr.
.ggg..yrry..ggg.
yy..rr.gg.rr..yy
..gg..rrrr..gg..
....yy.yy.yy....
................
................
................
................
