................
....yyy..yyy....
g.g.r.r..r.r.g.g
y..r.g.yy.g.r..y
.y.y.yg..gy.y.y.
.gg..rr..rr..gg.
...yy......yy...
.....rg..gr.....
.......rr.......
................
................
................
................
................
