................
yyyyyyyyyyyyyyyy
ggg.r.r..r.r.ggg
y..r.g.yy.g.r..y
................
................
................
................
................
................
................
................
................
................
